1111111111111111111111111111111111
10000000000000C0000000000000000001
1000000000000000000000000000000001
1000111110101111100000000000001101
1P00100010101000C000000000000001C1
10001111001010111000000E0000000011
10001000101010C0100000000000000011
1000111110101111100000000000000001
1000000000000000000000000000000111
1000000000000000C000000000000000C1
1111111111111111111111111111111111