1111111111111111111111111111111111
10000000000000C0000000000000000011
1110000100100000101001000000011001
1000000010101010001001000000001101
1P00000000100000C0000000E0000001C1
1111111111111111111111111111111111