1111111111111111111111111111111111
1E000000000000C0000000000000000001
1010010100100000101001000000011001
1010010010101010001001000000001101
1P00000000000000C000000000000001C1
1111111111111111111111111111111111